# Map 4
                                                                                                                        NOOOO
             3                                             o     o              3                                       NOOOO
                                                     o      o    o                                                      NOOOO
    QRS                o o o        o o o       o     o      o                     5Q                                   NOOOO
    NOP               WTTTTTU      WTTTTTU       o     o         3                5QOS                       3          NOOOO
    KLM                                           o        3     ooo             5QOOOS                     3           NOOOO
                                  3              3   QS         WTTTU           5QOOOOOS         QS        3            NOOOO
                 QS                                 QOP                        5QOOOOOOOS        NP       3             NOOOO
 &      QS  6    NP       5     5     5      6     QOOP   6     5             5QOOOOOOOOOS 6 QS 6NP       5    6     *  NOOOO
RRRRRRRROORRRRRRROORRRRRRRRRRRRRRRRRRRRRRRRRRRRRRRROOOORRRRRRRRRRRRRRRRRRRRRRRROOOOOOOOOOORRROORROORRRRRRRRRRRRRRRRRRRRROOOOO
