# Map 9
BF                             EB
AD                             CA
AD                             CA
AD                             CA
AD                             CA
AD                             CA
AD                             CA
AD                             CA
AD                             CA
AD ~~~~@      ^               *CA
AHBBBBBBBBBBBBBBBBBBBBBBBBBBBBBHA
